1111111111111
1001000000001
1000011111001
1000110C00PE1
1111111111111
