1111111111111
1001000000001
10000100P0001
1000110C000E1
1111111111111
